{
  "level_maps": [
    {
      "level": 1,
      "map": [
        0, 0, 0, 0, 0, 0, 0, 0,
        0, 0, 1, 1, 1, 0, 0, 0,
        1, 1, 1, 0, 1, 0, 0, 0,
        0, 0, 0, 0, 1, 0, 1, 1,
        0, 0, 0, 0, 1, 1, 1, 0,
        0, 0, 0, 0, 0, 0, 0, 0
      ],
      "cols": 8,
      "rows": 6
    }
  ]
}